1111111111111111111111111111
1111111111000001100000000001
1111111110000011100001000001
1111111100000111100011000001
1111111000001111100111000001
1111110000011111101111000001
1111100000111111111111000001
1111000001111111111110000011
1110000011111111111100000111
1100000111111111111000001111
1000001111111111110000011111
1000000000000001100000111111
1000000000000001100000111101
1000000000000001100000111001
1000000000000001100000110001
1111111111000001100000100001
1111111111000001100000000001
111111111100N001111111111111
1111111111000001111111111111
1111111111111111111111111111