1111111111111111111111111111111111111111111111111
1000000000000000000000000000000000000000000000001
1011111111111111111111100000001100011111111111101
1011111111111111100001110000011110111100000111101
1011111100001110011000011100110011000001111111101
1011110000111111111110000000100001000111110011101
1011000111110000111111100000111111001110000111101
1011111111000000000111111001111111100000000000101
1011111110111100000000000001101001100110001110001
1011111111100000000111000000101001000011011000001
1011111000000000001110000000100101000011011001101
1011100000000001101100000000100101000001110011101
1011000000000011111111000000101111000011111011101
1011000000000110011100000001111111100000000001101
1010000000000000000000000011010101110000001110101
1010001111100000000000000010111111010000011111101
1011111111111111000111100011111111110000111111101
1011110000011111111111110011110001110011111111101
1011000000000111111100000001100100100111110001101
1010000000000000000000000001000100101110000011101
1010000000000000000000000001010000100000011111101
1000011111000011111100000001010000100000111111101
1000110001100100000111100001000011100001111111101
1000111110111001111111110001100001100111111111101
1001111111011011111111111001111010101111000111101
1011100011110111111000011101110010100000000011101
1000000001101111000000000001111010100001101111101
1000000111111110000000000001110000100001100111101
1000001011111111110000000001111100100011110001101
1000011111111111110000000001110010100011010000101
1000000000111100000000000001111100100110111000001
1000000000000000000000000001111111111100001100001
1000000000000000000000000011111000111011111110001
1000000000000000000000000010011111110000000011001
1000000000010000000000000011111001111111111111001
1000000001110000000000000111111100111000000010001
1000000011010000000000111100000011111001001010001
1000000110110000000111110101101011011001001010001
1000001100110000000101010101101011011111111111001
1000001001111000000101011111111111111000000001001
1000011001111000000111111111111111111111111110001
1000010011111000000111111100000000001111110010001
1000010011111100000011111111101101111111000010001
1000011111111110000011111100110111011111111010001
1000000000100000000011111111000000111001110010001
1000001111111100000011111101101101101100111010001
1011100111111011011111011110011111000110011010001
1000111000000110110010001100111011111111111011101
1011000111011001111110111110110001000010011011101
1000011001100011010110001101110001011010011010001
1011100110110010111110111110110001011010011110001
1011111111111011011110011110110001011010010010001
1000110011000010101110111101110001011010011110001
1011000100011111100111111111111111011010011111001
1000000001110001110110001000000001011010011111101
1000111111111110111111111111111111011010111110101
1011111111111111001100001000000001111111110001101
1011111111110111100011111111111111111111111111101
1011011111101101110000000000000000000011111111101
1011101011111011111011001101011001111111101010101
1011010101111101110100110010100111111110110111001
1011111110110111101011001111011111111101111110101
10000000000000000000000000000000000000000000000S1
1111111111111111111111111111111111111111111111111