  111   111
 11011 11011
1100011100011
1000001000001
1000000000001
110000N000011
 11000000011
  110000011
   1100011
    11011
     111