NO ./textures/cupidon.xpm
SO ./textures/cupidon.xpm
WE ./textures/heart.xpm
EA ./textures/heart.xpm

C 163,186,228
F 228,163,198

   11111  11111
 1110001111000111
 1000000110000001
110000000000000011
100000000000000001
100000000000000001
100000000000000001
100000000000000001
110000000000000011
 1000000000000001
 1100000000000011
  11000000000011
   110000000011
    11000N0011
     11000011
      110011
       1111