NO ./textures/cupidon.xpm
SO ./textures/cupidon.xpm
WE ./textures/heart.xpm
EA ./textures/heart.xpm

C 163,186,228
F 228,163,198

    111    111
  110001  100011
 1000000110000001
 1000000000000001
100000000000000001
100000000000000001
100000000000000001
100000000000000001
 1000000000000001
 1000000000000001
  10000000000001
   100000000001
    1000000001
     1000N001
      100001
       1001
        11