NO ./textures/1.xpm
SO ./textures/2.xpm
WE ./textures/3.xpm
EA ./textures/4.xpm

C 0,0,255
F 255,0,255

111111111111111111111111
100000000000W00000000001
111111111111111111111111