NO ./textures/1.xpm
SO ./textures/2.xpm
WE ./textures/3.xpm
EA ./textures/4.xpm

C 112,83,130
F 181,174,96

11111
10001
10N01
10001
11111