1111111111111111111111111111111
1000000000000101000000000000001
10E0000000000101000000000000001
1000000000000101000000000000001
1111111111000101000000111110001
1000000001000101000000100010001
1111111101000101000000111010001
1000000101000101000000001010001
1000000111000101110000001010001
1000000000000100010000001010001
1000000111000111110000001010001
1000000101000000000000001010001
1000000101000000000000001010001
1000000101000000000000001010001
1111111111111111111111111111111