NO ./textures/mario.xpm
SO ./textures/peach.xpm
WE ./textures/luigi.xpm
EA ./textures/bowser.xpm

C 255,0,0
F 0,255,0

11111111111111111111
10000000000000000001
10000000011110111001
10000001100011000101
10000010000001000101
10000100011111100101
10001000111111110101
10001011000000111001
10011110001010100101
10010110001010100101
10100111000000010101
10100010010000010101
10010000111100111001
10001100001111101001
10000111000001001001
10001000111111010001
10010000011001100001
10100011101000110001
10100100011100010001
10101000001110011001
10011000001001111001
10001100011001100101
10010011111111000101
10110111111111000101
10100111111111000101
10100111110001001101
10100110000000111001
100110000N0000000001
10000000000000000001
11111111111111111111