NO ./textures/wall1.xpm
SO ./textures/wall2.xpm
WE ./textures/wall3.xpm
EA ./textures/wall4.xpm

C 56,56,56
F 113,113,113

11111
10001
10S01
10001
11011111111111111111
 1010000000000000001
 1010111010111111111
 1000100010000000001
 1011101111111110101
 1010001000000010101
 1011111011111011101
 1000100000001010001
 1110101111101010101
 1000101000101010101
 1110101010101010101
 1000100010101000101
 1011111110111111111
 1000000010100000001
 1111101010101111101
 10001010100010001011111
 10111010111110101010001
 10000010000000101000001
 11111111111111111110001
                   11111