NO ./textures/pikachu.xpm
SO ./textures/bulbizarre.xpm
WE ./textures/salameche.xpm
EA ./textures/carapuce.xpm
F 255,255,0
C 0,255,0

11111111111111111111111111111111111111111111111
10000000000000000000000000000000000000000000001
10000000010000000000000000000000000000000000001
10000000111000000000000000000000000000000000001
10000000111000000000000000000000000000000000001
10000000111100000000000000000000000000000000001
10000001111100000000000000000000001110000000001
10000001111110000000000000000001111110000000001
10000001111010000000000000000111111110000000001
10000001110010000000000000011011111100000000001
10000000100001000000000000100011111100000000001
10000000100001000000000011000001111000000000001
10000000100001000000000100000001110000000000001
10000000010001111111111000000001100000000000001
10000000010000000000000000000010000000000000001
10000000001000000000000000001100000000001100001   
10000000010000000000000000110000000000110010001
10000000100000000000110000100000000001000010001
10000000101100000001011000010000000010000000001
10000001010100000001101000010000001100000001001
10000001011100000000110000010000010000000001001
10000010011000100000000110001001100000000001001
10000011000000000010001111001110000000000001001
10000011000001111100001111011011000000000001001
10000101100000111100001111101000100000000001001
10001011100000111100000110100001100000000110001
10010000100000011000000001000000100000011000001
10001000010000000000000010000001000001100000001
10001000011000000000000000000001000010000000001
10000100010000000000000000000011000100000000001
10000010000000000000000000000100100010000000001
10000001100000000000000000000100010001000000001
10000000100000000000000000011001100000100000001
10000001000000000000000000101110000011000000001
10000001000000000000000000001000001100000000001
10000010000000000000000000010000110000000000001
10000111000000000000000000010001000000000000001
10001001100000000000000000011000100000000000001
10001101010000000000000000010111010000000000001
10001000010000000000000000011111101000000000001
10000100001000000000000000011111110000000000001
10000010001000000000000000111110000000000000001
10000010001000000000000000110000000000000000001
10000001110000000000000001100000000000000000001
10000000001111110000000001000000000000000000001
10000000000000011100000110000000000000000000001
10000000000000000111111100000000000000000000001
10000000000000000100001000000000000000000000001
10000000000000000100001000000000000000000000001
10000000000000000101010000000000000000000000001
10000000000000000011100000000000000000000000N01
10000000000000000000000000000000000000000000001
11111111111111111111111111111111111111111111111