NO ./textures/wall1.xpm
SO ./textures/wall2.xpm
WE ./textures/wall3.xpm
EA ./textures/wall4.xpm

C 56,56,56
F 113,113,113

111111111111111111111111111111111
100000000000000000000000000000001
101111111001000010111110111111101
101000001011011111000010100000101
101011101001110011100110101110101
101011101011010101111100101110101
101011101000101110011110101110101
101000001010100001110010100000101
101111111010101010101010111111101
100000000000001010100100000000001
101111101111101011110001010101001
100010110101000010100110111000101
100100111001011111110001100000001
101000000001110011000110010101001
100111011001010111110100000110001
100110100001101001101101101000101
100111011100000111001010110110001
101101100010001011100010111001001
100000111011101011010000010110001
101011000010100110100110111010101
101001001011111001100000010010001
101000100011010001101100011001001
101000101010010110110111111011101
100000000011101000001010001111101
101111111010100101011110101110001
101000001000101010100110001000101
101011101010101011110011111011101
101011101011000010111100010111101
101011101011011001101100111111001
101000001010010010101110010101001
101111111011011000111101011110001
1000000000000000000000000000000S1
111111111111111111111111111111111