11111111111111111111111111111111111111111111111111111111111111
10000000000001010000000000000011000000000000101000000000000001
10E00000000001010000000000000011000000000000101000000000000001
10000000000001010000000000000011000000000000101000000000000001
11111111110001010000001111100011000000000000101000000000000001
10000000010001010000001000100011000000000000101000000000000001
11111111010001010000001110100011000000000000101000000000000001
10000001010001010000000010100011000000000000101000000000000001
10000001110001011100000010100011000000000000101000000000000001
10000000000001000100000010100011000000000000101000000000000001
10000001110001111100000010100011000000000000101000000000000001
10000001010000000000000010100011000000000000101000000000000001
10000001010000000000000010100011000000000000101000000000000001
10000001010000000000000010100011000000000000101000000000000001
11111111111111111111111111111111111111111111111111111111111111
1111111111111111111111111111111
1000000000000101000000000000001
1000000000000101000000000000001
1000000000000101000000000000001
1111111111000101000000111110001
1000000001000101000000100010001
1111111101000101000000111010001
1000000101000101000000001010001
1000000111000101110000001010001
1000000000000100010000001010001
1000000111000111110000001010001
1000000101000000000000001010001
1000000101000000000000001010001
1000000101000000000000001010001
1111111111111111111111111111111
1111111111111111111111111111111
1000000000000101000000000000001
1000000000000101000000000000001
1000000000000101000000000000001
1111111111000101000000111110001
1000000001000101000000100010001
1111111101000101000000111010001
1000000101000101000000001010001
1000000111000101110000001010001
1000000000000100010000001010001
1000000111000111110000001010001
1000000101000000000000001010001
1000000101000000000000001010001
1000000101000000000000001010001
1111111111111111111111111111111