NO ./textures/1.xpm
SO ./textures/2.xpm
WE ./textures/3.xpm
EA ./textures/4.xpm

C 0,0,255
F 255,0,255

11111
10001
10N01
10001
1101